#######################
# A   #     #     #     #
# ### # ### # ### # ### #
#   # # #   #   # #   # #
### # # # ### ### # # # #
#   #   # #   #   # # # #
# ##### # # ### ### # # #
#     # # #   # #   #   #
##### # # ##### # ##### #
#   # # #   #   #   #   #
# # # # # # # # ### # # #
# #   #   # # #   # # # #
# ### ### # # ### # # # #
# #     # # #   # # # # #
# # ### # # ### # # # # #
#   #   #   #   #     # #
### # ##### # ##### ### #
#   #     #   #     #   #
# ### # ##### # ##### ###
# #   #       #       # #
# # ######### # ####### #
# #           #         #
##################### B #