##    #
## ## #
#B #  #
#### ##
#    ##
A######